name	meaning
Hermes	Mercury; gain; refuge
Johanan	who is liberal or merciful
Chesil	foolishness
Jetur	order; succession; mountainous
Simon	that hears; that obeys
Bajith	a house
Uzziel	the strength, or kid, of the Lord
Geliloth	rolling, wheel, heap
Areopagus	the hill of Mars
Darda	home of knowledge
Jehovah-nissi	the Lord my banner
Jah	the everlasting
Athaiah	the Lord's time
Etam	their bird, their covering
Elimelech	my God is king
Azgad	a strong army; a gang of robbers
Shalem	same as Salem
Machbanai	poverty; the smiting of his son
Baalah	her idol; she that is governed or subdued; a spouse
Nedabiah	prince or vow of the Lord
Belteshazzar	who lays up treasures in secret
Teraphim	images; idols
En-tappuah	fountain of an apple, or of inflation
Dibri	an orator
Abiah	the Lord is my father
Jarah	a wood; honeycomb; watching closely
Decapolis	containing ten cities
Rephael	the physic or medicine of God
Shemeber	name of force; name of the strong
Shapham	rabbit; wild rat; their lip; their brink
Zimmah	thought; wickedness
Jerubbaal	he that defends Baal, let Baal defend his cause
Senaah	bramble; enemy
Tabeal	good God
Miletum	red; scarlet
Joktan	small dispute; contention; disgust
Jehiskiah	the strength, or taking, of the Lord
Japhet	enlarged; fair; persuading
Hali	sickness; a beginning; a precious stone
Shochoh	defense; a bough
Edrei	a very great mass, or cloud
Jabez	sorrow; trouble
Cnidus	age
Pashur	that extends or multiplies the hole; whiteness
Balaam	the ancient of the people; the destruction of the people
Boson	taking away
Pentapolis	five cities
Moladah	birth; generation
Michri	selling
Chisleu	rashness; confidence
Moses	taken out; drawn forth
Achshaph	poison; tricks
Janoah	resting; tarrying; deriving
Apollonia	perdition, destruction
Bethshan	house of the tooth, or of ivory, or of sleep
Jahaziah	the vision of the Lord
Riblah	quarrel; greatness to him
Esek	contention
Hadlai	loitering; hindering
Jehozabad	the Lord's dowry; having a dowry
Joakim	rising or establishing of the Lord
Baal-tamar	master of the palm-tree
Ammi	same as Ammah
Aznoth-tabor	the ears of Tabor; the ears of purity or contrition
Bethphage	house of my month, or of early figs
Jael	he that ascends; a kid
Tammuz	abstruse; concealed; consumed
Hodiah	same as Hodaiah
Shamir	prison; bush; lees; thorn
Hammon	heat; the sun
Meshillamith	peaceable; perfect; giving again
Shehariah	mourning or blackness of the Lord
Chilion	finished; complete; perfect
Elnaam	God's fairness
Henoch	same as Enoch
Zithri	to hide; demolished
Teman	the south; Africa; perfect
Maachah	pressed down; worn; fastened
Tarah	a hair; a wretch; one banished
Hoham	woe to them
Eshean	held up
Manaen	a comforter; a leader
Hierapolis	holy city
Phalec	same as Peleg
Semaiah	obeying the Lord
Gibbar	strong, manly
Ibri	passing over; being angry; being with young
Cush	Ethiopians; blackness
Andrew	a strong man
Uel	desiring God
Beth-shemesh	house of the sun
Merab	he that fights or disputes
Zalmon	his shade; his image
Besodeiah	counsel of the Lord
Tahan	beseeching; merciful
Punites	beholding; my face
Habakkuk	he that embraces; a wrestler
Luhith	made of boards
Melzar	circumcision of a narrow place, or of a bond
Antothijah	answers or songs of the Lord; afflictions
Lycaonia	she-wolf
Apollyon	a destroyer
Betharabah	house of sweet smell
Taralah	searching out slander, or strength
Eleph	learning
Geshuri	sight of the valley; a walled valley
Ammizabad	dowry of the people
Ispah	a jasper stone
Jehoiarib	fighting, or multiplying, of the Lord
Iscariot	a man of murder; a hireling
Exodus	going out, departure
Sheariah	gate of the Lord; tempest of the Lord
Aphek	strength; a rapid torrent
Ether	talk
Jesaiah	health, or salvation, of the Lord
Aroer	heath; tamarisk
Paseah	passing over; halting
Peor	hole; opening
Upharsin	divided
Hothir	excelling; remaining
Rezon	lean; small; secret; prince
Irshemesh	a city of bondage
Ahiman	brother of the right hand
Meshelemiah	peace, or perfection, of the Lord
Meribbaal	he that resists Baal; rebellion
Neah	moved; moving
Ammihud	people of praise
Gallio	who sucks, or lives on milk
Hanes	banishment of grace
Amashai	the people's gift
Joram	to cast; elevated
Jeruel	fear, or vision of God
Jorai	showing; casting forth; a cauldron
Jorah	showing; casting forth; a cauldron
Bizjothjah	despite
Marah	bitter; bitterness
Zophim	place for a watchman
Dilean	that is poor
Hazo	seeing; prophesying
Hatita	a bending of sin
Sabaoth	Lord of hosts
Goliath	passage; revolution; heap
Alexander	one who assists men
Sanballat	bramble-bush; enemy in secret
Sardis	prince of joy
Almon-diblathaim	hidden in a cluster of fig trees
Arnon	rejoicing; sunlight
Hor	who conceives, or shows; a hill
Igeal	a redeemer; redeemed; defiled
Hod	praise; confession
Jeriel	fear, or vision of God
Ruth	drunk; satisfied
Haahashtari	a runner
Ariel	altar; light or lion of God
Zeruah	leprous; wasp; hornet
Diblaim	cluster of figs
Ahishar	brother of a prince; brother of a song
Mammon	riches
Amorite	bitter; a rebel; a babbler
Horeb	desert; solitude; destruction
Jochebed	glorious; honorable
Hymeneus	nuptial; the god of marriage
Dizahab	where much gold is
Augustus	increased, augmented
Huram	their liberty; their whiteness; their hole
Orpah	the neck or skull
Horem	an offering dedicated to God
Bilshan	in the tongue
Shamgar	named a stranger; he is here a stranger
Jambres	poverty; bitter; a rebel
Ahikam	a brother who raises up or avenges
Baasha	he that seeks, or lays waste
Matred	wand of government
Othni	my time; my hour
Azmon	bone of a bone; our strength
Noph	honeycomb; anything that distills or drops
Hallelujah	praise the Lord
Kirjath-huzoth	city of streets; populous city
Ramoth	eminences; high places
Zebah	victim; sacrifice
Baalath	a rejoicing; our proud lord
Naphtali	that struggles or fights
Jemuel	God's day; son of God
Sarid	remaining; hand of a prince
Michal	who is perfect?
En-haddah	quick sight; well of gladness
Jew	same as Judah
Stachys	spike or ear of corn
Daniel	judgment of God; God my judge
Jashub	a returning; a controversy; a dwelling place
Jaddua	known
Mahaz	an end; ending; growing hope
Geshur	sight of the valley; a walled valley
Beth-lehem	house of bread
Julia	downy; soft and tender hair
Pochereth	cutting of the mouth of warfare
Minni	reckoned; prepared
Huzoth	streets; populous
Jahaz	quarrel; dispute
Mordecai	contrition; bitter; bruising
Eli	my God, my God
Aholah	his tabernacle; his tent
Rhegium	rupture; fracture
Shomer	keeper; dregs
Cabbon	as though understanding
Antipas	for all, or against all
Ishmerai	keeper, or keeping
Adriel	the flock of God
Tahapenes	secret temptation
Abib	green fruit; ears of corn
Tochen	middle
Memucan	impoverished; to prepare; certain; true
Elizur	God is my strength; my rock; rock of God
Pasach	thy broken piece
Baal-shalisha	the god that presides over three; the third idol
Amittai	true; fearing
Ephes-dammim	effusion of blood
Jokshan	an offense; hardness; a knocking
Unni	poor; afflicted; that answers
Rizpah	bed; extension; a coal
Alush	mingling together
Miriam	rebellion
Ahishahur	brother of the morning or dew; brother of blackness
Eutychus	happy; fortunate
Melea	supplying; supplied
Apollos	one who destroys; destroyer
Berachiah	speaking well of the Lord
Salma	peace; perfection
Gennesaret	garden of the prince
Hazarenan	imprisoned cloud
Mispar	numbering; showing; increase of tribute
Jalon	tarrying; murmuring
Rabmag	who overthrows or destroys a multitude
Shaveh	the plain; that makes equality
Elzaphan	God of the northeast wind
Bamah	an eminence or high place
Laadan	for pleasure; devouring; judgment
Jehudijah	the praise of the Lord
Laadah	to assemble together; to testify; passing over
Elhanan	grace, or gift, or mercy of God
Magpiash	a body thrust hard together
Aholibah	my tent, or my tabernacle, in her
Admah	earthy; red; bloody
Shalisha	three; the third; prince; captain
Pekod	noble; rulers
Bealoth	cast under
Shimeah	that hears, or obeys; perdition
Azrikam	help, revenging
Enoch	dedicated; disciplined
Jamlech	reigning; asking counsel
Esther	secret; hidden
Seba	a drunkard; that turns
Jogbehah	an exalting; high
Aphiah	speaking, blowing
Samos	full of gravel
Amasa	sparing the people
Merari	bitter; to provoke
Bedan	according to judgment
Amon	faithful; true
Bedad	alone; solitary
Labana	the moon; whiteness; frankincense
Rhesa	will; course
Shemuel	appointed by God
Euphrates	that makes fruitful
Chenani	my pillar
Shuphim	wearing them out; their shore
Uzzen-sherah	ear of the flesh
Miamin	the right hand
Hillel	he that praises
Nephthoah	opening; open
Mekonah	a foot of a pillar; provision
Jarvah	breathing, or making, a sweet smell
Shobach	your bonds; your chains
Bethemek	house of deepness
Hauran	a hole; liberty; whiteness
Jazeel	strength of God
Oshea	same as Joshua
Erech	length; health; physic
Ramiah	exaltation of the Lord
En-shemesh	fountain, or eye, of the sun
Anub	same as Anab
Aceldama	field of blood
Chittem	those that bruise; gold
Hazarmaveth	dwelling of death
Amos	loading; weighty
Chloe	green herb
Akkub	foot-print; supplanting; crookedness; lewdness
Archelaus	the prince of the people
Golan	passage; revolution
Ellasar	revolting from God
Tidal	that breaks the yoke; knowledge of elevation
Libni	same as Libnah
Zeboiim	deer; goats
Timnath-serah	image of the sun; numbering of the rest
Tyres	strength; rock; sharp
Oboth	dragons; fathers; desires
Idbash	flowing with honey; the land of destruction
Ithream	excellence of the people
Elam	a young man; a virgin; a secret
Elah	an oak; a curse; perjury
Messiah	anointed
Jair	my light; who diffuses light
Jekamiah	establishing, or revenging, of the Lord
Dagon	corn; a fish
Eshtaol	a strong woman
Apocrypha	hidden
Didymus	a twin; double
Zebina	flowing now; selling; buying
Azur	he that assists or is assisted
Eluzai	God is my strength
Keros	crooked; crookedness
Ziklag	measure pressed down
Joah	fraternity; brother of the Lord
Matthanias	same as Mattaniah
En-hazor	the grass of the well
Assyria	country of Assur or Ashur
Jakim	rising; confirming; establishing
Adummim	earthy; red; bloody things
Samlah	his raiment; his left hand; his astonishment
Mehir	a reward
Kitron	making sweet; binding together
Philadelphia	love of a brother
Naphish	the soul; he that rests, refreshes himself, or respires
Hamath	anger; heat; a wall
Shuthelah	plant; verdure; moist; pot
Shinab	father of changing
Caiphas	he that seeks with diligence; one that vomiteth
Esmachiah	joined to the Lord
Hadadrimmon	invocation to the god Rimmon
Shinar	watch of him that sleeps
Zobebah	an army; warring
Careah	bald; ice
Elidad	beloved of God
Beth-peor	house of gaping, or opening
Helek	part; portion
Jehonadab	free giver; liberality
Jeremai	my height; throwing forth waters
Helem	dreaming; healing
Salem	complete or perfect peace
Beth-lebaoth	house of lionesses
Heled	the world; rustiness
Kithlish	it is a wall; the company of a lioness
Benhanan	son of grace
Sosipater	who defends the father
Paran	beauty; glory; ornament
Janohah	resting; tarrying; deriving
Abel-beth-maachah	mourning to the house of Maachah
Ohad	praising; confessing
Shilhi	bough; weapon; armor
Zabbai	flowing
Hamath-zobah	the heat, or the wall, of an army
Ishbi-benob	respiration; conversion; taking captive
Jahath	broken in pieces; descending
Tahpenes	standard; flight; temptation
Arioch	long; great; tall
Malchiah	the Lord my king, or my counselor
Habor	a partaker; a companion
Tarsus	winged; feathered
Chisloth-tabor	fears; purity
Silas	three, or the third
Huldah	the world
Rehum	merciful; compassionate
Hittite	one who is broken; who fears
Hukkok	engraver; scribe; lawyer
Satan	contrary; adversary; enemy; accuser
Sechu	defense; bough
Abiasaph	consuming father; gathering
Jesse	gift; oblation; one who is
Susi	horse; swallow; moth
Pharisees	set apart
Tubal	the earth; the world; confusion
Haggeri	a stranger
Nebat	that beholds
Piram	a wild ass of them
Zatthu	olive tree
Tarshish	contemplation; examination
Deuel	the knowledge of God
Abishua	father of salvation
Nebai	budding; speaking; prophesying
Hashabniah	the silence of the Lord
Gareb	a scab
Phebe	shining; pure
Elath	a hind; strength; an oak
Kirjath-jearim	city of woods
Helkath-hazzurim	the field of strong men, or of rocks
Libya	the heart of the sea; fat
Ezel	going abroad; walk
Thaddeus	that praises or confesses
Shilshah	three; chief; captain
Crete	carnal; fleshly
Titus	pleasing
Gudgodah	happiness
Habaiah	the hiding of the Lord
Mattana	gifts; rains
Epaphras	covered with foam
Cain	possession, or possessed
Azaniah	hearing the Lord; the Lord's weapons
Abez	an egg; muddy
Ammiel	the people of God
Jordan	the river of judgment
Dura	same as Dor
Job	he that weeps or cries
Achish	thus it is; how is this
Hoshaiah	the salvation of the Lord
Thummim	perfection; truth
Bernice	one that brings victory
Telassar	taking away; heaping up
Obal	inconvenience of old age
Lotan	wrapt up; hidden; covered; myrrh; rosin
Abiud	father of praise
Beeliada	an open idol
Gemalli	wares; a camel
Baca	a mulberry-tree
Gershon	his banishment; the change of pilgrimage
Gershom	a stranger here
Naomi	beautiful; agreeable
Kirjathaim	the two cities; callings; or meetings
Abishur	father of the wall; father of uprightness
Shema	hearing; obeying
Chenaanah	broken in pieces
Serah	lady of scent; song; the morning star
Mephaath	appearance, or force, of waters
Lemuel	God with them, or him
Andronicus	a man excelling others
Sanhedrin	sitting together
Gazabar	a treasurer
Shillem	peace; perfection; retribution
Lebbeus	a man of heart; praising; confessing
Jazer	assistance; helper
Mitylene	purity; cleansing; press
Mispereth	numbering; showing; increase of tribute
Taanach-shilo	breaking down a fig-tree
Jeroham	high; merciful; beloved
Poratha	fruitful
Ribai	strife
Goath	his touching; his roaring
Capernaum	the field of repentance; city of comfort
Shophan	rabbit; hid
Israel	who prevails with God
Ithiel	sign, or coming of God
Baaseiah	in making; in pressing together
Jerijah	same as Jeriah
Hegai	or Hege, meditation; word; groaning; separation
Hazar-hatticon	middle village; preparation
Ed	witness
Mithnite	loin; gift; hope
Matthias	same as Mattathias
Sadoc	or Zadok, just; righteous
Chelluh	all
Shaalabbim	understanding, or son of a fox
Sadducees	followers of Sadoc, or Zadok
Ater	left hand; shut
Bildad	old friendship
Michaiah	same as Micah
Selah	the end; a pause
Ain	same as Aiath
Babylon	same as Babel
Ishi	salvation
Zuriel	rock or strength of God
Millo	fullness
Mikloth	little wants; little voices; looking downward
Mahlah	same as Mahali
David	well-beloved, dear
Ammi-nadab	my people is liberal
Jada	knowing
Seirath	hairy; goat; demon; tempest
Dophkah	a knocking
Asahel	creature of God
Elihu	he is my God himself
Palti	deliverance; flight
Megiddon	same as Megiddo
Havilah	that suffers pain; that brings forth
Lamech	poor; made low
Laodicea	just people
Gomer	to finish; complete
Philologus	a lover of letters, or of the word
Hamon-gog	the multitude of Gog
Jotham	the perfection of the Lord
Meunim	dwelling-places; afflicted
Mahali	infirmity; a harp; pardon
Ahasuerus	prince; head; chief
Uphaz	pure gold; gold of Phasis or Pison
Heldai	the world; rustiness
Machi	poor; a smiter
Aaron	a teacher; lofty; mountain of strength
Nebuchadrezzar	tears and groans of judgment
Amashi-ali	same as Amaziah
Shebarim	breakings; hopes
Chun	making ready
Jozabad	same as Josabad
Iddo	his band; power; praise
Abner	father of light
Nicopolis	the city of victory
Jaazah	helper
Bashemath	perfumed; confusion of death; in desolation
Huri	being angry; or same as Huram
Chelub	a basket
Azmaveth	strong death; a he-goat
Jaazar	helper
Huzzab	molten
Hoglah	his festival or dance
Kolariah	voice of the Lord
Tabitha	clear-sighted; a roe-deer
Hadashah	news; a month
Nepheg	weak; slacked
Timnath	image; figure; enumeration
Sheleph	who draws out
Ahiram	brother of craft, or of protection
Tabrimon	good pomegranate; the navel; the middle
Paulus	same as Paul
Josibiah	the seat, or captivity of the Lord
Obadiah	servant of the Lord
Shitrai	gatherer of money
Eleazar	help of God, court of God
Ije-abarim	heaps of Hebrews, or of passers over
Zia	sweat; swelling
Zif	this or that; brightness; comeliness
Gilboa	revolution of inquiry
Pedahzur	strong or powerful savior; stone of redemption
Kanah	of reeds
Anak	a collar; ornament
Anah	one who answers; afflicted
Jehudi	praising; conferring
Ziz	flower; branch; a lock of hair
Anab	a grape; a knot
Timnah	forbidding
Adullam	their testimony; their prey; their ornament
Jashen	ancient; sleeping
Jashem	ancient; sleeping
Elijah	God the Lord, the strong Lord
Hazargaddah	imprisoned band
Abinoam	father of beauty
Adaliah	one that draws water; poverty; cloud; death
Pagiel	prevention, or prayer, of God
Jasher	righteous; upright
Ramath-lehi	elevation of the jaw-bone
Enan	cloud
Jerioth	kettles; breaking asunder
Enam	fountain, open place
Gispa	coming hither
Aristobulus	a good counselor
Gittites	men of Gath, ie., of a wine-press
Beeri	my well
Philip	warlike; a lover of horses
Jiphtah	opening
Nisan	standard; miracle
Hepher	a digger
Beera	a well; declaring
Julius	same as Julia
Joelah	lifting up; profiting; taking away slander
Salmon	peaceable; perfect; he that rewards
Hezir	a bog; converted
Moserah	erudition; discipline
Jahmai	warm; making warm
Mishma	hearing; obeying
Menahem	comforter; who conducts them; preparation of heat
Hodaiah	the praise of the Lord
Ishmachiah	cleaving to the Lord
Adbeel	vapor, or cloud of God
Assur	same as Ashur
Shual	fox; path; first
Archippus	a master of horses
Absalom	father of peace
Cherethites	who cut or tear away
Palestina	which is covered; watered; or brings and causes ruin
Taberah	burning
Ard	one that commands; he that descends
Zibiah	the Lord dwells; deer; goat
Bethany	the house of song; the house of affliction
Parosh	a flea; the fruit of a moth
Bethsaida	house of fruits, or of food, or of snares
Hapharaim	searching; digging
Pethahiah	the Lord opening; gate of the Lord
Shashai	rejoicing; mercy; linen
Shashak	a bag of linen; the sixth bag
Zebudah	endowed; endowing
Anaharath	dryness, burning, wrath
Middin	judgment; striving
Sceva	disposed; prepared
Shophach	pouring out
Mattatha	his gift
Jokmeam	confirmation, or revenge, of the people
Elzabad	the dowry of God
Sabtah	a going about or circuiting; old age
Caleb-Ephratah	see Ephratah
Urbane	courteous
Heres	the son; an earthen pot
Lebanon	white, incense
Persis	same as Persia
Jeshebeab	sitting, or captivity, of the father
Jaakobah	supplanter; deceiver; the heel
Ulla	elevation; leaf; young child
Shadrach	tender, nipple
Shaalbim	that beholds the heart
Zaccheus	pure; clean; just
Shebna	who rests himself; who is now captive
Moriah	bitterness of the Lord
Beulah	married
Nabal	fool; senseless
Nathanael	the gift of God
Tyrus	strength; rock; sharp
Taphath	distillation; drop
Ichabod	where is the glory? or, no glory
Cornelius	of a horn
Joseph	increase; addition
Salcah	thy basket; thy lifting up
Kerioth	the cities; the callings
Semachiah	joined to the Lord
Jaala	ascending; a little doe or goat
Baruch	who is blessed
Jannes	who speaks or answers; afflicted; poor
Elihoreph	god of winter, or of youth
Beth-aven	the house of vanity; of iniquity of trouble
Elioenai	toward him are mine eyes; or to him are my fountains
Elishua	God is my salvation
Ahio	his brother; his brethren
Roman	strong; powerful
Arimathea	a lion dead to the Lord
Hivites	wicked; wickedness
Cleophas	the whole glory
Adonikam	the Lord is raised
Asher	happiness
Phlegon	zealous; burning
Levi	associated with him
Machbenah	poverty; the smiting of his son
Abdon	servant; cloud of judgment
Ahuzam	their taking or possessing vision
Barjesus	son of Jesus or Joshua
Kehelahath	a whole; a congregation
Jeuz	he that is devoured
Betah	confidence
Jehud	praising; conferring
Pul	bean; destruction
Achaia	grief; trouble
Shemiramoth	the height of the heavens
Eldaah	knowledge of God
Heleb	the world; rustiness
Barachias	same as Barachel
Pur	lot
Succoth-benoth	the tents of daughters, or young women; or prostitutes
Izhar	clearness; oil
Adah	an assembly
Jezer	island of help
Adam	earthy; red
Zeeb	wolf
Bozrah	in tribulation or distress
Zaccai	pure meat; just
Claudia	lame
Sarai	my lady; my princess
Nadab	free and voluntary gift; prince
Solomon	peaceable; perfect; one who recompenses
Emmanuel	God with us
Sia	moving; help
Adar	high; eminent
Samaria	watch-mountain
Sharezer	overseer of the treasury, or of the storehouse
Midian	judgment; covering; habit
Charran	a singing or calling out
Rosh	the head; top, or beginning
Aphekah	strength; a rapid torrent
Abaddon	the destroyer
Abinadab	father of a vow, or of willingness
Joezer	he that aids
Jehoram	exaltation of the Lord
Delilah	poor; small; head of hair
Regemmelech	he that stones the king; purple of the king
Gebal	bound; limit
Jehohanan	grace, or mercy, or gift, of the Lord
Mellicu	his kingdom; his counselor
Atarah	a crown
Segub	fortified; raised
Garmites	men of Garmi, ie., bones, or, my cause
Magdiel	declaring God; chosen fruit of God
Barjona	son of a Jona; of a dove
Ben-ammi	son of my people
Zereth	same as Zer
Jerebai	fighting; chiding; multiplying
Hadarezer	same as Hadadezer
Ava	or Ivah, iniquity
Gabriel	God is my strength
Bethanath	house of affliction
Enon	cloud; mass of darkness; fountain; eye
Azzur	same as Azur
Zephon	that sees and observes; that expects or covers
Lucas	luminous; white
Kirjath-arba	city of four; fourth city
Elon	oak; grove; strong
Zoheleth	that creeps, slides, or draws
Prochorus	he that presides over the choirs
Tiberias	good vision; the navel
Jaalam	hidden; young man; heir
Raddai	ruling; coming down
Rezin	good-will; messenger
Hazelelponi	sorrow of countenance
Mahath	same as Maath
On	pain; force; iniquity
Ahithophel	brother of ruin or folly
Jeaterai	searching out
En-gedi	eye, or fountain, of the goat, or of happiness
Charchemish	a lamb; as taken away; withdrawn
Hormah	devoted or consecrated to God; utter destruction
Zuzims	the posts of a door; splendor; beauty
Uzal	wandering
Gethsemane	a very fat or plentiful vale
Stephen	same as Stephanas
Pelonite	falling; secret
Mahanaim	tents; two fields; two armies
Hakkoz	a thorn; summer; an end
Zebedee	abundant; portion
Eneas	laudable
Lo-ruhamah	not having obtained mercy; not pitied
Festus	festive, joyful
Trophimus	well educated; well brought up
Pinon	pearl; gem; that beholds
Mark	same as Marcus
Phalti Palti	deliverance, flight
Mara	bitter; bitterness
Darius	he that informs himself
Bekah	half a shekel
Sansannah	bough or bramble of the enemy
Mary	same as Miriam
Jamin	right hand; south wind
Baal-hamon	who rules a crowd
Elnathan	God hath given; the gift of God
Ebal	ancient heaps
Helez	armed; set free
Baal-berith	idol of the covenant
Hushai	their haste; their sensuality; their silence
Hushah	hasting; holding peace
Beerelim	the well of Elim, or of rains
Eladah	the eternity of God
Ammishaddai	the people of the Almighty; the Almighty is with me
Pharez	division; rupture
Adoram	their beauty; their power
Justus	just or upright
Ginath	a garden
Madmannah	measure of a gift; preparation of a garment
Jerah	the moon; month; smelling sweet
Zorah	leprosy; scab; hornet
Irijah	the fear of the Lord
Neri	my light
Isui	same as Ishuah
Phichol	the mouth of all, or every tongue
Achim	preparing; revenging; confirming
Jahaleel	praising God; light of God
Jairus	my light; who diffuses light
Eliphaz	the endeavor of God
Kirharaseth	city of the sun; wall of burnt brick
Kibroth-hattaavah	the graves of lust
Asiel	the work of God
Janna	who speaks or answers; afflicted; poor
Belial	wicked, worthless
Irpeel	the health, medicine, or exulting of God
Gibeah	a hill
Mehujael	who proclaims God
Eliphal	a miracle of God
Binea	son of the Lord
Hiddekel	sharp voice; sound
Ashtaroth	flocks; sheep; riches
Ozem	that fasts; their eagerness
En-rimmon	well of weight
Judas	same as Judah
Thahash	that makes haste; that keeps silence
Amplias	large; extensive
Jehoaddan	pleasure, or time, of the Lord
Theophilus	friend of God
Dionysius	divinely touched
Pentecost	fiftieth
Anani	a cloud; prophecy; divination
Jehovah-jireh	the Lord will provide
Elasah	the doings of God
Chemarims	black ones
Sorek	vine; hissing; a color inclining to yellow
Kallai	light; resting by fire; my voice
Ulam	the porch; the court; their strength; their folly
Gilalai	a wheel
Ulai	strength; fool; senseless
Togarmah	which is all bone
Casluhim	hopes of life
Tophet	a drum; betraying
Gallim	who heap up; who cover
Lapidoth	enlightened; lamps
Melech	king; counselor
Tolad	a generation
Tophel	ruin; folly; without understanding
Kirioth	same as Kerioth
Mahli	same as Mahali
Allon-bachuth	the oak of weeping
Gederothaim	hedges
Abdi	my servant
Hattush	forsaking sin
Zuph	that beholds, observes, watches; roof; covering
Jedeiah	one Lord; the joy of the Lord
Abda	a servant; servitude
Gergesenes	those who come from pilgrimage or fight
Dabareh	the word; the thing; a bee; obedient
Shaphat	judge
Shicron	drunkenness; his gift; his wages
Chislon	hope, trust
Maaseiah	the work of the Lord
Rufus	red
Mahanem	a comforter
Amram	an exalted people; their sheaves; handfuls of corn
Vajezatha	sprinkling the chamber
Attai	same as Athlai
Seleucia	shaken or beaten by the waves
Ramathaim-zophim	the two watch-towers
Sotai	conclusion in pleading; binding
Eglah	heifer; chariot; round
Baal-zebub	god of the fly
Jidlaph	he that distills water
Paltiel	deliverance; or banishment, of God
Shelumiel	same as Shelemiah
Medad	he that measures; water of love
Bethabara	the house of confidence
Tanhumeth	consolation; repentance
Ebiasaph	a father that gathers or adds
Medan	judgment; process
Shimron	same as Shimri
Hatach	he that strikes
Jesiah	sprinkling of the Lord
Hermas	Mercury; gain; refuge
Jabal	which glides away
Kirharesh	city of the sun; wall of burnt brick
Bul	old age; perishing
Gedaliah	God is my greatness
Esau	he that acts or finishes
Rhoda	a rose
Ahaziah	seizure; vision of the Lord
Isaiah	the salvation of the Lord
Idalah	the hand of slander, or of cursing
Taanach	who humbles thee; who answers thee
Naham	comforter; leader
Syracuse	that draws violently
Athaliah	the time of the Lord
Noah	that quavers or totters (Zelophehad's daughter)
Barak	thunder, or in vain
Shamed	destroying; wearing out
Ardon	ruling; a judgment of malediction
Putiel	God is my fatness
Jekabzeel	the congregation of God
Eliab	God is my father; God is the father
Harod	astonishment; fear
Cephas	a rock or stone
Mered	rebellious, ruling
Pharaoh	that disperses; that spoils
Amalek	a people that licks up
Tychicus	casual; by chance
Eliam	the people of God
Jezebel	chaste
Beth-azmaveth	house of death's strength
Kedar	blackness; sorrow
Nod	vagabond; fugitive
Noe	same as Noah
Shelomith	my peace; my happiness; my recompense
Meshullam	peaceable; perfect; their parables
Meres	defluxion; imposthume
Luz	separation; departure; an almond
Jahdo	I alone; his joy; his sharpness of wit; his newness
Ibzan	father of a target; father of coldness
Tarea	howling; doing evil
Mercurius	an orator; an interpreter
Pilate	armed with a dart
Nahash	snake; serpent
Reu	his friend; his shepherd
Malchus	my king, kingdom, or counselor
Sherebiah	singing with the Lord
Ezri	my help
Ram	elevated; sublime
Tabor	choice; purity; bruising
Shammah	loss; desolation; astonishment
Shammai	my name; my desolations
Haggith	rejoicing
Ezra	help; court
Epher	dust; lead
Spain	rare; precious
Nehushta	made of brass
Gadarenes	men of Gadara, i.e., a place surrounded or walled
Lael	to God; to the mighty
Mizzah	defluxion from the head
Beelzebub	same as Baalzebub
Dor	generation, habitation
Jeush	he that is devoured
Jehubbah	hiding, binding
Phurah	that bears fruit, or grows
Jagur	husbandman; stranger
Abednego	servant of light; shining
Bohan	in them
Peulthai	my works
Pathros	Pathrusim, mouthful of dough; persuasion of ruin
Siddim	the tilled field
Rezeph	pavement; burning coal
Elkoshite	a man of Elkeshai
Calvary	the place of a skull
Ophrah	dust; lead; a fawn
Myra	I flow; pour out; weep
Dothan	the law; custom
Aphik	strength; a rapid torrent
Zilpah	distillation from the mouth
El-beth-el	the God of Bethel
Nodab	vowing of his own accord
Chushan-rishathaim	blackness of iniquities
Besor	glad news; incarnation
Kelitah	same as Kelaiah
Shelah	that breaks; that unties; that undresses
Shamhuth	desolation; destruction
Perez-Uzza	division of Uzza, or of strength
Shephi	beholder; honeycomb; garment
Antichrist	an adversary to Christ
Shepho	desert
Othniel	the hour of God
Thamah	that blots out; that suppresses
Chelubai	he altogether against me
Mnason	a diligent seeker; an exhorter
Nogah	brightness; clearness
Accho	close; pressed together
Moloch	king
Shealtiel	same as Salathiel
Diklah	his diminishing
Heshmon	a hasty messenger
Tryphena	delicious; delicate
Chelal	as night
Purim	lot
Rabbah	great; powerful; contentious
Atad	a thorn
Mehuman	making an uproar; a multitude
Siloam	same as Shilhi
Gibbethon	a back; a high house
Shuah	ditch; swimming; humiliation
Apocalypse	uncovering, revelation
Parnach	a bull striking, or struck
Ephratah	abundance; bearing fruit
Padan-aram	cultivated field or table-land
Bethuel	filiation of God
Adna	pleasure; delight
Joahaz	apprehending; possessing; seeing
Zin	buckler; coldness
Ham	hot; heat; brown
Remphan	prepared; arrayed
Shaul	asked; lent; a grave
Zichri	that remembers; that is a man
Rab-shakeh	cup-bearer of the prince
Kenizzites	possession; purchase
Zethar	he that examines or beholds
Kirjath-baal	city of Baal, or of a ruler
Chorazin	the secret; here is a mystery
Beno	his son
Ophel	a tower; darkness; small white cloud
Eglon	same as Eglah
Jupiter	the father that helpeth
Nimshi	rescued from danger
Potiphar	bull of Africa; a fat bull
Jonah	or Jonas, a dove; he that oppresses; destroyer
Minnith	same as Minni
Jonan	a dove; multiplying of the people
Zerubbabel	a stranger at Babylon; dispersion of confusion
Michtam	golden psalm
Gera	pilgrimage, combat; dispute
Pallu	marvelous; hidden
Jetheth	giving
John	the grace or mercy of the Lord
Joha	who enlivens or gives life
Agee	a valley; deepness
Pethuel	mouth of God; persuasion of God
Jokim	that made the sun stand still
Tel-melah	heap of salt
Zaretan	tribulation; perplexity
Leah	weary; tired
Ishua	plainness; equal
Calah	favorable; opportunity
Cisleu	rashness; confidence
Haran	mountainous country
Ahimelech	my brother is a king; my king's brother
Herodion	the song of Juno
Eltolad	the generation of God
Aran	an ark; their curse
Aram	highness, magnificence, one that deceives; curse
Arab	multiplying; sowing sedition; a window; a locust
Shoham	keeping back
Peruda	same as Perida
Arad	a wild ass; a dragon
Thomas	a twin
Mehetabel	how good is God
Bechorath	first fruits
Beri	my son; my corn
No	stirring up; forbidding
Bera	a well; declaring
Ephesus	desirable
Laban	white; shining; gentle; brittle
Nagge	clearness; brightness; light
Mebunnai	son; building; understanding
Birsha	an evil; a son who beholds
Abel	a city; mourning
Adramyttium	the court of death
Romamti-ezer	exaltation of help
Jahzeel	God hasteth, or divideth
Kirjath-sepher	city of letters, or of the book
Igal	redeemed; defiled
Nymphas	spouse; bridegroom
Bedeiah	the only Lord
Adoni-zedek	justice of the Lord; lord of justice
Alemeth	hiding; youth; worlds; upon the dead
Felix	happy, prosperous
Cherethims	who cut or tear away
Sarsechim	master of the wardrobe
Jehoiachin	preparation, or strength, of the Lord
Tilon	murmuring
Sheshbazzar	joy in tribulation; joy of the vintage
Nebuchadnezzar	tears and groans of judgment
Jehezekel	strength of God
Uriel	same as Uriah
Zerah	same as Zarah
Jadau	his hand; his confession
Reba	the fourth; a square; that lies or stoops down
Beth-zur	house of a rock
Iscah	he that anoints
Aven	iniquity; force; riches; sorrow
Athlai	my hour or time
Hizkijah	the strength of the Lord
Jesimiel	naming, or astonishment, of God
Lahad	praising; to confess
Libnah	white; whiteness
Rechab	square; chariot with team of four horses
Joanna	grace or gift of the Lord
Adoniram	my Lord is most high; Lord of might and elevation
Paarai	opening
Achzib	liar; lying; one that runs
Eliasaph	the Lord increaseth
Nahbi	very secret
Jabneel	building of God
Neziah	conqueror; strong
Abidah	father of knowledge
Abidan	father of judgment
Lysimachus	scattering the battle
Jimnah	right hand; numbering; preparing
Pirathon	his dissipation or deprivation; his rupture
Jethro	his excellence; his posterity
Nason	helper; entry-way
Araunah	ark; song; joyful cry
Benhail	son of strength
Shoa	kings; tyrants
Horonaim	angers; ragings
Pisidia	pitch; pitchy
Meshech	who is drawn by force
Necho	lame; beaten
Beth-car	the house of the lamb
Nethinims	given or offered
Tikvah	hope; a little line; congregation
Olympas	heavenly
Beer	a well
Bukkiah	the dissipation of the Lord
Bileam	the ancient of the people; the devourer
Agur	stranger; gathered together
Saul	asked; lent; a grave
Michmach	he that strikes
Tahrea	anger; wicked contention
Gog	roof; covering
Tekoa	trumpet; that is confirmed
Gob	cistern; grasshopper
Talmai	my furrow; that suspends the waters; heap of waters
Mizpah	a watch-tower; speculation
Arah	the way; a traveler
Jehoiakim	avenging, or establishing, or resurrection, of the Lord
Hananiah	grace; mercy; gift of the Lord
Tetrarch	governor of a fourth part
Joed	witnessing; robbing; passing over
Jehoiada	knowledge of the Lord
Shebam	compassing about; old men
Cherith	cutting; piercing; slaying
Joel	he that wills or commands
Palal	thinking
Colosse	punishment; correction
Zaavan	trembling
Izri	fasting; tribulation
Mareshah	from the beginning; an inheritance
Shimei	that hears or obeys; my reputation; my fame
So	a measure for grain; vail
Homam	making an uproar
Nahum	comforter; penitent
Japhlet	delivered; banished
Pelaliah	entreating the Lord
Harsha	workmanship; a wood
Tohu	that lives; that declares
Amnon	faithful and true; tutor
Nebo	that speaks or prophesies
Dodavah	love
Shedeur	field of light; light of the Almighty
Melatiah	deliverance of the Lord
Jothath	his goodness
Nimrim	leopard; bitterness; rebellion
Lois	better
Carpus	fruit; fruitful
Addon	basis; foundation; the Lord
Metheg-ammah	bridle of bondage
Beth-barah	the chosen house
Calno	our consummation; altogether himself
Gammadims	dwarfs
Shaalbonite	a fox's building
Dimon	where it is red
Malcham	their king; their counselor
Geuel	God's redemption
Henadad	grace of the beloved
Elisheba	same as Elisabeth
Boaz	or Booz, in strength
Adadah	testimony of the assembly
Mattaniah	gift, or hope, of the Lord
Adaiah	the witness of the Lord
Naarai	young person
Abiezer	father of help
Uthai	my iniquity
Sebat	twig; scepter; tribe
Rachab	same as Rahab
Asnapper	unhappiness; increase of danger
Jeshishai	ancient; rejoicing exceedingly
Rachal	to whisper; an embalmer
Cuthah	burning
Malchiel	God is my king, or counselor
Maharai	hasting; a hill; from a hill
Chiliab	totality; or the perfection of the father
Pedaiah	redemption of the Lord
Artaxerxes	the silence of light; fervent to spoil
Jozachar	remembering; of the male sex
Ikkesh	forward; wicked
Rithmah	juniper; noise
Sered	dyer's vat
Heresh	a carpenter
Esaias	same as Isaiah
Baanah	in the answer; in affliction
Azekah	strength of walls
Zebadiah	portion of the Lord; the Lord is my portion
Tirshatha	a governor
Philemon	who kisses
Matthew	given; a reward
Zaanannim	movings; a person asleep
Horonites	men of anger, or of fury, or of liberty
Bartimeus	son of the honorable
Helam	their army; their trouble
Baal-hermon	possessor of destruction or of a thing cursed
Sitnah	hatred
Cesar	a name applied to those who are cut out of the womb
Ahuzzah	possession; seizing; collecting
Allon	an oak; strong
Rinnah	song; rejoicing
Nisroch	flight; proof; temptation; delicate
Nain	beauty; pleasantness
Hinnom	there they are; their riches
Samothracia	an island possessed by the Samians and Thracians
Nobah	that barks or yelps
Shulamite	peaceable; perfect; that recompenses
Dathan	laws or rites
Assir	prisoner; fettered
Holon	a window; grief
Asenath	peril; misfortune
Leshem	a name; putting; a precious stone
Arba	four
Lekah	walking; going
Raguel	shepherd, or friend of God
Sarepta	a goldsmith's shop
Bidkar	in compunction, or sharp pain
Cilicia	which rolls or overturns
Zedad	his side; his hunting
Micaiah	who is like to God?
Aiah	vulture, raven; an isle; alas, where is it?
Obed	a servant; workman
Harosheth	a forest; agriculture; workmanship; deafness; silence
Tobijah	the Lord is good
Euodias	sweet scent
Beneberak	sons of lightning
Ashriel	same as Asareel
Ir	watchman; city; vision
Pisgah	hill; eminence; fortress
Regem	that stones or is stoned; purple
Hoshama	heard; he obeys
Tebah	murder; butchery; guarding of the body; a cook
Nachon	ready; sure
Deborah	word; thing; a bee
Pi-hahiroth	the mouth; the pass of Hiroth
Nachor	same as Nahor
Kittim	breaking; bruising small; gold; coloring
Telabib	a heap of new grain
Molid	nativity; generation
Potipherah	that scatters abroad, or demolishes, the fat
Benoni	son of my sorrow, or pain
Zalmunna	shadow; image; idol forbidden
Juttah	turning away
Ahlab	made of milk, or of fat; brother of the heart
Hadid	rejoicing; sharp
Omega	the last letter of the Greek alphabet; long O
Lucius	luminous; white
Zohar	white; bright; dryness
Harum	high; throwing down
Sinon	a breast-plate; deliverance
Mash	same as Meshech
Lucifer	bringing light
Zabdi	same as Zabad
Azubah	forsaken
Haruz	careful
Benimi	our sons
Zerahiah	the Lord rising; brightness of the Lord
Raham	compassion; a friend
Tirhakah	inquirer; examiner; dull observer
Secundus	second
Sihor	black; trouble (the river Nile)
Onesimus	profitable; useful
Rahab	large; extended (name of a woman)
Sihon	rooting out; conclusion
Sisera	that sees a horse or a swallow
Maarath	den; making empty; watching
Mejarkon	the waters of Jordan
Dalphon	the house of caves
Seth	put; who puts; fixed
Zeruiah	pain or tribulation of the Lord
Diana	luminous, perfect
Ami	mother; fear; people
Hareph	winter; reproach
Nekoda	painted; inconstant
Arphaxad	a healer; a releaser
Pelethites	judges; destroyers
Sallai	an exaltation; a basket
Tyrannus	a prince; one that reigns
Nineveh	handsome; agreeable
Beth-birei	the house of my Creator, the house of my health
Nebushasi-hahban	speech; prophecy; springing; flowing
Sherah	flesh; relationship
Ataroth	crowns
Havoth-jair	the villages that enlighten
Maath	wiping away; breaking; fearing; smiting
Zebulun	dwelling; habitation
Mesobaite	the Lord's standing-place; a little doe
Sheber	breaking; hope
Karkor	they rested
Immanuel	God with us
Berith	covenant
Sepharad	a book descending
Jeduthun	his law; giving praise
Rimmon	exalted; pomegranate
Ephrath	abundance; bearing fruit
Tirzah	benevolent; complaisant; pleasing
Kadesh-barnea	holiness of an inconstant son
Dan	judgment; he that judges
Zadok	just; justified
Laish	a lion
Massah	temptation
Jiphthael	God opening
Dalmatia	deceitful lamps; vain brightness
Nazareth	separated; crowned; sanctified
Zanoah	forgetfulness; desertion
Kishon	hard; sore
Alvah	his rising up; his highness
Jedidiah	beloved of the Lord
Mattithiah	same as Mattathias
Jezoar	clear; white
Cheran	anger
Ucal	power, prevalency
Tubal-cain	worldly possession; possessed of confusion
Aniam	a people; the strength or sorrow of people
Jahdiel	the unity, or sharpness, or revenge, of God
Kidron	obscure; making black or sad
Pasdammin	portion or diminishing of blood
Bashan	in the tooth, in ivory
Ishiah	it is the Lord
Nereus	same as Ner
Jeberechiah	speaking well of, or kneeling to, the Lord
Coz	a thorn
Ramah	same as Ram
Nergal	the great man; the hero
Tebeth	good, goodness (the tenth month of the Hebrews)
Malluch	reigning; counseling
Jemima	handsome as the day
Gaash	tempest; commotion
Ono	grief or strength or iniquity of him
Jeconiah	preparation, or stability, of the Lord
Jezrahiah	the Lord arises; brightness of the Lord
Anathema	separated; set apart
Elizabeth	the oath, or fullness, of God
Stephanas	crown; crowned
Ziha	brightness; whiteness; drought
Eliakim	resurrection of God
Ahasbai	trusting in me; a grown-up brother
Temani	the south; Africa; perfect
Gaza	strong; a goat
Zoar	little; small
Kareah	bald; ice
Zoan	motion
Reuben	who sees the son; the vision of the son
Askelon	weight; balance; fire of infamy
Sion	noise; tumult
Ahiezer	brother of assistance
Kir	a city; wall; meeting
Eliada	knowledge of God
Ummah	darkened; covered; his people
Machir	selling; knowing
Parshandatha	given by prayer
Candace	who possesses contrition
Bene-jaakan	sons of sorrow
Vashti	that drinks; thread
Maaz	wood; wooden
Ramath	raised; lofty
Hur	liberty; whiteness; hole
Abarim	passages; passengers
Beth-nimrah	house of rebellion
Kishi	hardness; his gravity; his offense
Tiphsah	passage; leap; step; the passover
Adiel	the witness of the Lord
Hilkiah	God is my portion
Igdaliah	the greatness of the Lord
Sisamai	house; blindness
Edom	red, earthy; of blood
Gimzo	that bulrush
Carmi	my vineyard; lamb of the waters
Tertius	third
Sheshach	bag of flax or linen
Helkai	same as Helek
Uzzah	strength; goat
Puah	mouth; corner; bush of hair
Anem	or Anen, an answer; their affliction
Aner	answer; song; affliction
Babel	confusion; mixture
Zibeon	iniquity that dwells
Higgaion	meditation; consideration
Paruah	flourishing; that flies away
Imri	speaking; exalting; bitter; a lamb
Sippai	threshold; silver cup
Nephusim	same as Nephishesim
Ijon	look; eye; fountain
Jerimoth	he that fears or rejects death
En-dor	fountain, eye of generation, or of habitation
Nahallal	praised; bright
Ahimaaz	a brother of the council
Phanuel	face or vision of God
Zechariah	same as Zachariah
Jachin	he that strengthens and makes steadfast
Dimonah	dunghill
Cuth	burning
Achbor	a rat; bruising
Shachia	protection of the Lord
Peniel	face or vision of God; that sees God
Zenas	living
Berothath	of a well
James	same as Jacob
Sidon	hunting; fishing; venison
Jasiel	the strength of God
Sinai	a bush; enmity
Kushaiah	same as Kishi
Nahath	rest; a leader
Zenan	coldness; target; weapon
Galeed	the heap of witness
Tappuah	apple; swelling
Shunem	their change; their sleep
Enos	mortal man; sick; despaired of; forgetful
Dedan	their breasts; friendship; a judge
Balak	who lays waste or destroys
Penuel	same as Peniel
Hannah	gracious; merciful; he that gives
Mishael	who is asked for or lent
Naharai	my nostrils; hot; anger
Ragau	friend; shepherd
Tryphosa	thrice shining
Lahairoi	who liveth and seeth me
Barsabas	son of return; son of rest
Aretas	agreeable, virtuous
Hasrah	wanting
Shittim	thorns
Thelasar	same as Telassar
Gederah	a wall
Belshazzar	master of the treasure
Jehalelel	praising God; clearness of God
Zair	little; afflicted; in tribulation
Ithmah	an orphan
Eph-lal	judging; praying
Ashtoreth	flocks; sheep; riches
Bozez	mud; bog
Ibneiah	the building of the Lord; the understanding of the Lord;
Peter	a rock or stone
Hilen	a window; grief
Zimran	song; singer; vine
Apelles	exclusion; separation
Mahavites	declaring a message; marrow
Claudius	lame
Hanun	gracious; merciful
Shamsherai	there a singer or conqueror
Emmor	an ass
Abel-shittim	mourning of thorns
Madai	a measure; judging; a garment
Zephaniah	the Lord is my secret
Gilead	the heap or mass of testimony
Philetus	amiable; beloved
Sephar	book; scribe; number
Ammah	my, or his, people
Shephuphan	serpent
Mishal	parables; governing
En-gannim	eye, or fountain, of protection or of gardens
Misham	their savior; taking away
Nehushtan	a trifling thing of brass
Tadmor	the palm-tree; bitterness
Kelaiah	voice of the Lord; gathering together
Socoh	tents; tabernacles
Kibzaim	congregation
Blastus	that buds or brings forth
Rabboni	my master
Anim	answerings; singings; afflicted
Zalaph	shadow; ringing; shaking
Abel-mizraim	the mourning of Egyptians
Menan	numbered; rewarded; prepared
Shemaiah	that hears or obeys the Lord
Hamoth	indignation
Cyrene	a wall; coldness; the floor
Perez	divided
Bezai	eggs
Terah	to breathe; scent; blow
Cushi	Ethiopians; blackness
Hoshea	savior; safety
Isaac	laughter
Mahanehdan	tents of judgment
Dibzahab	where much gold is
Parbar	a suburb
Pontius	marine; belonging to the sea
Lystra	that dissolves or disperses
Elisha	salvation of God
Sodi	my secret
Azaz	strong one
Cenchrea	millet; small pulse
Pharpar	that produces fruit
Jeheiel	God liveth
Bethesda	house of pity or mercy
Maher-shalal-hash-baz	making speed to the spoil; he hastens to the prey
Nahaliel	inheritance; valley of God
Idumea	red; earthy; bloody
Sophereth	scribe, numbering
Eshtemoa	the bosom of a woman
Sychar	end
Attalus	increased, nourished
Gaius	lord; an earthly man
Calneh	our consummation
Lazarus	assistance of God
Eran	follower
Hanani	my grace; my mercy
Jegar-sahadutha	heap of witness
Iturea	guarded; mountainous
Hanameel	the grace that comes from God; gift of God
Hophin	he that covers; my fist
Amraphel	one that speaks of secrets
Jeshimon	solitude; desolation
Hori	a prince; freeborn
Mesha	burden; salvation
Japho	fairness; comeliness
Shethar	putrefied; searching
Accad	a vessel; pitcher; spark
Padon	his redemption; ox-yoke
Alleluia	praise the Lord
Beth-el	the house of God
Jekamean	the people shall arise
Ararat	the curse of trembling
Hattipha	robbery
Sin	bush
Shaashgaz	he that presses the fleece; that shears the sheep
Dalmanutha	a bucket; a branch
En-mishpat	fountain of judgment
Gaddiel	goat of God; the Lord my happiness
Beth-haran	house of grace
Uzai	he
Eber	one that passes; anger
Peresh	horseman
Gezer	dividing, sentence
Hashub	esteemed; numbered
Hashum	silence; their hasting
Elim	the rams; the strong; stags
Nimrod	rebellion (but probably an unknown Assyrian word)
Elkeshai	hardiness or rigor of God
Jonathan	given of God
Ebed	a servant; laborer
Ephraim	fruitful; increasing
Eve	living; enlivening
Jushabhesed	dwelling-place; change of mercy
Ibleam	ancient people; people decreasing
Rogelim	a foot or footman
Megiddo	his precious fruit; declaring a message
Evi	unjust
Rhodes	same as Rhoda
Shaphan	rabbit; wild rat; their lip; their brink
Lachish	who walks, or exists, of himself
Bunni	building me
Macedonia	burning; adoration
Chenaniah	preparation, or disposition, or strength, of the Lord
Salamis	shaken; test; beaten
Jehaziel	same as Jahaziel
Adlai	my witness; my ornament
Zelophehad	the shade or tingling of fear
Jahazah	quarrel; dispute
Hadadezer	beauty of assistance
Jucal	mighty; perfect
Mithcah	sweetness; pleasantness
Vashni	the second; changed; a tooth
Aquila	an eagle
Elul	cry or outcry
Matri	rain; prison
Azazel	the scape-goat
Jashobeam	the people sitting; or captivity of the people
Elymas	a magician, a corrupter
Judea	same as Judah
Ashkenaz	a fire that spreads
Nebuzar-adan	fruits or prophecies of judgment
Tibni	straw; hay
Gibeon	hill; cup; thing lifted up
Ophni	wearisomeness; folding together
Hattil	howling for sin
Abraham	father of a great multitude
Rehabiah	breadth, or extent, of the Lord
Zorobabel	same as Zerubbabel
Resen	a bridle or bit
Jearim	a leap; woods
Eshek	violence, force
Kish	hard; difficult; straw; for age
Eder	a flock
Vophsi	fragrant; diminution
Adin	adorned; voluptuous; dainty
Leummim	countries; without water
Eden	pleasure; delight
Baal-peor	master of the opening
Eliezer	help, or court, of my God
Salathiel	asked or lent of God
Tiglath-pileser	that binds or takes away captivity
Magor-missabib	fear on every side
Hazar-addar	an imprisoned generation
Hermogenes	begotten of Mercury
Amaziah	the strength of the Lord
Achaicus	a native of Achaia; sorrowing; sad
Epaphroditus	agreeable; handsome
Hiddai	a praise; a cry
Elpaal	God's work
Rab-saris	chief of the eunuchs
Nephthalim	same as Naphtali
Abishag	ignorance of the father
Josiphiah	increase of the Lord; the Lord's finishing
Ish-tob	good man
Adrammelech	the cloak, glory, grandeur or power of the king
Hagabah	a grasshopper
Ziba	army; fight; strength
Aholibamah	my tabernacle is exalted
Azzan	their strength
Jaaziel	the strength of the Lord
Jaasiel	God's work
Nethaneel	same as Nathanael
Elpalet	same as Eliphalet
Ecclesiastes	a preacher
Agabus	a locust; the father's joy or feast
Ashur	who is happy; or walks; or looks
Rakkon	vain; void; mountain of enjoyment
Agrippa	one who causes great pain at his birth
Gaal	contempt; abomination
Beth-phelet	same as Beth-palet
Sela-hammah-lekoth	rock of divisions
Hachmoni	a wise man
Merom	eminences; elevations
Gittaim	a wine-press
Amana	integrity; truth; a nurse
Hushathite	man of haste, or of silence
Meroz	secret, leanness
Maroth	bitterness
Hashubah	estimation; thought
Dodanim	beloved
Hamonah	his multitude; his uproar
Shiphi	multitude
Apphia	productive; fruitful
Reuel	the shepherd or friend of God
Galal	a roll, a wheel
Bedaiah	the only Lord
Ethni	strong
Chios	open; opening
Gad	a band; a troop
Abi	my father
Jaasau	doing; my doing
Abigail	the father's joy
Cyrus	as miserable; as heir
Hananeel	grace, or gift, of God
Ziphron	falsehood of a song; rejoicing
Nathan-melech	the gift of the king, or of counsel
Ittah-kazin	hour, or time, of a prince
Zabad	dowry; endowed
Phylacteries	things to be especially observed
Zoheth	separation; amazing
Chimham	as they; like to them
Mamre	rebellious; bitter; set with trees
Dinah	judgment; who judges
Hashupha	spent; made base
Gether	the vale of trial or searching
Jezaniah	nourishment, or weapons, of the Lord
Ramatha	raised; lofty
Tekel	weight
Joshaviah	the seat, alteration, or captivity of the Lord
Beth-aram	house of height
Ur	fire, light, a valley
Eliel	God, my God
Ishmael	God that hears
Nahshon	same as Naashon
Mesopotamia	between two rivers
Nahor	hoarse; dry; hot
Uz	counsel; words
Lashah	to call; to anoint
Eliashib	the God of conversion
Jokdeam	crookedness, or burning, of the people
Timotheus	honor of God; valued of God
Onesiphorus	who brings profit
Elishah	it is God; the lamb of God: God that gives help
Madian	judgment; striving; covering; chiding
Mazzaroth	the twelve signs of the zodiac
Massa	a burden; prophecy
Eliahba	my God the Father
Lehabim	flames; inflamed; swords
Camon	his resurrection
Muppim	out of the mouth; covering
Joses	same as Jose
Eldad	favored of God; love of God
Micha	same as Micaiah
Jehoadah	passing over; testimony of the Lord
Imrah	a rebel; waxing bitter; changing
Ai	or Hai, mass; heap
Daberath	same as Dabareh
Abiram	high father; father of deceit
Hen	grace; quiet; rest
Elishama	God hearing
Shihor-libnah	blackness of Libnah
Maadai	pleasant; testifying
Casiphia	money; covetousness
Ar	awakening; uncovering
Bebai	void, empty
Josiah	the Lord burns; the fire of the Lord
Maon	house; place of sin
Cis	same as Kish
Dishon	fatness; ashes
Bilhah	who is old or confused
Shimi	that hears or obeys; my reputation; my fame
Bilhan	who is old or confused
Colhozeh	every prophet
Chemosh	handling; stroking; taking away
Suah	speaking; entreating; ditch
Keiiah	she that divides or cuts
Erastus	lovely, amiable
Ahira	brother of iniquity; brother of the shepherd
Halak	part
Barzillai	son of contempt; made of iron
Halah	a moist table
Sibboleth	ear of corn; stream or flood
Berothai	wells; a cypress
Jezneel	seed of God
Mysia	criminal; abominable
Hezekiah	strength of the Lord
Zurishaddai	the Almighty is my rock and strength
Nephishesim	diminished; torn in pieces
Shammuah	he that is heard; he that is obeyed
Diotrephes	nourished by Jupiter
Beth-palet	house of expulsion
Hamul	godly; merciful
Mehida	a riddle; sharpness of wit
Chilmad	teaching or learning
Lahmam	their bread; their war
Bukki	void
Barachel	that bows before God
Abdiel	servant of God
Hakupha	a commandment of the mouth
Kedemah	oriental; ancient; first
Cainan	possessor; purchaser
Shuppim	wearing them out; their shore
Esar-haddon	that closes the point; joy; cheerfulness
Hannathon	the gift of grace
Azareel	help of God
Reelaiah	shepherd or companion to the Lord
Adoraim	strength of the sea
Nehum	comforter; penitent
Damascus	a sack full of blood; the similitude of burning
Anna	gracious; one who gives
Zophar	rising early; crown
Avith	wicked, perverse
Zippor	bird; sparrow; crown; desert
Jehush	keeping counsel; fastened
Abital	the father of the dew; or of the shadow
Cyprus	fair; fairness
Egypt	that troubles or oppresses; anguish
Naarah	young person
Mattan	gifts; rains
Dodo	his uncle
Sigionoth	according to variable songs or tunes,
Addi	my witness; adorned; prey
Ethanim	strong; valiant
Zamzummims	projects of crimes; enormous crimes
Imlah	plentitude; circumcision
Pudens	shamefaced
Sivan	a bush or thorn
Haggai	feast; solemnity
Elon-beth-hanan	the house of grace or mercy
Linus	net
Joshua	a savior; a deliverer
Beth-shean	house of the tooth, or of ivory, or of sleep
Ahlai	beseeching; sorrowing; expecting
Ekron	barrenness; torn away
Letushim	hammermen; filemen
Jephunneh	he that beholds
Kenites	possession; purchase; lamentation
Shimrath	hearing; obedient
Demetrius	belonging to corn, or to Ceres
Izrahiah	the Lord ariseth; the clearness of the Lord
Baladan	one without judgment
Koa	hope; a congregation; a line; a rule
Iphedeiah	redemption of the Lord
Neballat	prophecy; budding
Mibzar	defending; forbidding; taking away
Helon	window; grief
Achor	trouble
Girgashite	who arrives from pilgrimage
Diblath	paste of dry figs
Hazael	that sees God
Thebez	muddy; eggs; fine linen or silk
Migdalel	tower of God
Bezaleel	in the shadow of God
Beth-marcaboth	house of bitterness wiped out
Eubulus	prudent; good counselor
Kishion	hardness; soreness
Elishaphat	my God judgeth
Abel-meholah	mourning of sickness
Sibmah	conversion; captivity
Jecoliah	perfection, or power, of the Lord
Zilthai	my shadow; my talk
Puteoli	sulphureous wells
Ashima	crime; offense
Kinah	same as Kenah
Guni	a garden; a covering
Areli	the light or vision of God
Makas	same as Mahaz
Zipporah	beauty; trumpet; mourning
Sheva	vanity; elevation; fame; tumult
Syntyche	that speaks or discourses
Amasai	strong
Cozbi	a liar; sliding away
Zelotes	zealous
Azriel	same as Asriel
Adonijah	the Lord is my master
Memphis	abode of the good
Maasiai	the defense, or strength, or trust of the Lord
Bartholomew	a son that suspends the waters
Hosanna	save I pray thee; keep; preserve
Mashal	a parable; governing
Shilom	tarrying; peace-maker
Pelatiah	let the Lord deliver; deliverance of the Lord
Kirjath	city; vocation; meeting
Shiloh	sent; (city)peace; abundance
Ephah	weary; tired
Akrabbim	scorpions
Oreb	a raven
Melita	affording honey
Gomorrah	rebellious people
Kirjath-sannah	city of enmity, or of a blackberry bush
Kadmonites	ancients; chiefs
Ebronah	passage over; being angry
Zina	shining; going back
Azaliah	near the Lord
Hosea	savior; safety
Asareel	the beatitude of God
Phallu	Pallu, admirable; hidden
Peleg	division
Mattathias	the gift of the Lord
Korah	baldness; ice; frost
Zelah	rib; side; halting
Zebulon	dwelling; habitation
Micah	poor; humble
Lebonah	same as Labana
Adnah	eternal rest
Reumah	lofty; sublime
Beer-lahai-roi	the well of him that liveth and seeth me
Bahurim	choice; warlike; valiant
Nicanor	a conqueror; victorious
Hotham	a seal
Madon	a chiding; a garment; his measure
Beth-meon	house of the dwelling-place
Judah	the praise of the Lord; confession
Dodai	beloved
Salim	foxes; fists; path
Pi-beseth	abode of the goddess Bahest or Bast
Benzoheth	son of separation
Lydda	a standing pool
Sennacherib	bramble of destruction
Hodaviah	same as Hodaiah
Philistines	those who dwell in villages
Horims	princes; being angry
Abdeel	a vapor; a cloud of God
Onan	same as On
Susanna	lily; rose; joy
Hachaliah	who waits for the Lord
Milcom	their king
Quartus	fourth
Patrobas	paternal; that pursues the steps of his father
Sheminith	eighth (an eight-stringed instrument)
Baali	my idol; lord over me
Jaakan	tribulation; labor
Ithran	remaining; searching out diligently
Hanoch	dedicated
Baale	same as Baalath
Ahab	uncle, or father's brother
Ahumai	a meadow of waters; a brother of waters
Tiberius	the son of Tiber
Tebaliah	baptism, or goodness, of the Lord
Judaea	same as Judah
Tanach	same as Taanach
Telem	their dew; their shadow
Ahaz	one that takes or possesses
Mene	who reckons or is counted
Jebusi	trodden under foot; mangers
Jabneh	he that understands; building
Carmel	circumcised lamb; harvest; full of ears of corn
Rekem	vain pictures; divers picture
Mecherath	selling; knowledge
Gittah-hepher	digging; a wine-press
Jered	ruling; coming down
Eker	barren, feeble
Abishalom	father of peace
Jerubbesheth	let the idol of confusion defend itself
Seir	hairy; goat; demon; tempest
Rebekah	fat; fattened; a quarrel appeased
Canaan	merchant; trader; or that humbles and subdues
Gath-rimmon	the high wine-press
Beth-ezal	a neighbor's house
Remaliah	the exaltation of the Lord
Neriah	light; lamp of the Lord
Shechem	part; portion; back early in the morning
Shaaraim	gates; valuation; hairs
Bithron	divisions
Sheshai	six; mercy; flax
Gazez	a passing over
Tryphon	masculine of Tryphena
Sheshan	lily; rose; joy; flax
Zemira	song; vine; palm
Elmodam	the God of measure, or of the garment
Migdalgad	tower compassed about
Dedanim	the descendants of Dedan
Tola	worm; grub; scarlet
Chidon	a dart
Ebed-melech	the king's servant
Naum	same as Nahum
Gamul	a recompense
Ishbosheth	a man of shame
Heth	trembling; fear
Kadesh	holiness
Ephphatha	be opened
Hamutal	the shadow of his heat
Ahinadab	a willing brother; brother of a vow
Maadiah	pleasantness; the testimony of the Lord
Meronothite	my singing; rejoicing; bearing rule
Milcah	queen
Patmos	mortal
Esh-ban	fire of the sun
Horam	their hill
Christ	anointed
Anammelech	answer; poverty of the king
Moseroth	erudition; discipline
Emims	fears; terrors; formidable; people
Attalia	that increases or sends
Harnepher	the anger of a bull; increasing heat
Jedaiah	the hand of the Lord; confessing the Lord
Jediel	the knowledge, or renewing, of God
Tharah	same as Terah
Zillah	shadow; the tingling of the ear
Zophah	viol; honeycomb
Alammelech	God is king
Neiel	commotion, or moving, of God
Jediael	the science, or knowledge, of God
Rachel	sheep
Hebrews	descendants of Heber
Rabbi	my master
Er	watchman
Maleleel	same as Mahaleleel
Meshach	that draws with force
Shibboleth	ear of corn; stream or flood
Elealeh	burnt-offering of God
Jehoash	fire of the Lord
Sodom	their secret; their cement
Bealiah	the god of an idol; in an assembly
Matthal	gift; he that gives
Matthan	same as Mattan
Abimelech	father of the king
Cedron	black; sad
Jehoshua	same as Joshua
Cyrenius	who governs
Bilgah	ancient countenance
Zared	strange descent
Shelomi	my peace; my happiness; my recompense
Elohi	God
Jahleel	waiting for, or beseeching, or hope in, God
Bunah	building; understanding
Maachathi	broken
Zaza	belonging to all
Bathsheba	the seventh daughter; the daughter of satiety
Mearah	den; cave; making empty
Jehaleleel	praising God; clearness of God
Jogli	passing over; turning back; rejoicing
Nathan	given; giving; rewarded
Asshurim	liers in want; beholders
Debir	an orator; a word
Jeezer	island of help
Eshcol	bunch of grapes
Jarib	fighting; chiding; multiplying; avenging
Zimzi	my field; my vine
Haruphite	slender; sharp
Shimrith	same as Shimri
Shisha	of marble; pleasant
Serug	branch; layer; twining
Zidon	hunting; fishing; venison
Achsah	adorned; bursting the veil
Jehoshaphat	the Lord is judge
Nezib	standing-place
Karnaim	horns
Omri	sheaf of corn
Hazaiah	seeing the Lord
Samuel	heard of God; asked of God
Adamah	red earth; of blood
India	praise; law
Mushi	he that touches, that withdraws or takes away
Og	a cake; bread baked in ashes
Beraiah	the choosing of the Lord
Persia	that cuts or divides; a nail; a gryphon; a horseman
Ezbon	hastening to understand
Obil	that weeps; who deserves to be bewailed
Abba	father
Addin	adorned; delicious; voluptuous
Chaldea	as demons, or as robbers
Damaris	a little woman
Shiloah	same as Siloah
Baalis	a rejoicing; a proud lord
Meribah	dispute; quarrel
Melchi-shua	king of health; magnificent king
Baalim	idols; masters; false gods
Shushan	lily; rose; joy
Patara	trodden under foot
Joshah	being; forgetting; owing
Hermon	anathema; devoted to destruction
Zemaraim	wool; pith
Dibon-gad	great understanding; abundance of sons
Gabbatha	high; elevated
Dumali	silence; resemblance
Hor-hagidgad	the hill of felicity
Belah	destroying
Haman	noise; tumult
Iconium	coming
Maale-akrabbim	ascent of scorpions
Annas	one who answers; humble
Timnath-heres	image of the sun; numbering of the rest
Mallothi	fullness; circumcision
Shibmah	overmuch captivity, or sitting
Hosah	trusting
Gatam	their lowing; their touch
Rumah	exalted; sublime; rejected
Noadiah	witness, or ornament, of the Lord
Ocran	a disturber; that disorders
Manahethites	my lady; my prince of rest
Mibhar	chosen; youth
Iim	heaps of Hebrews, or of angry men
Perazim	divisions
Chozeba	men liers in wait
Hiel	God lives; the life of God
Admatha	a cloud of death; a mortal vapor
Neariah	child of the Lord
Iram	the effusion of them; a high heap
Shecaniah	habitation of the Lord
Chesulloth	fearfulness
Illyricum	joy; rejoicing
Seneh	same as Senaah
Aeneas	praised; praiseworthy
Saph	rushes; sea-moss
Zuar	same as Zoar
Jehiah	the Lord liveth
En-rogel	the fuller's fountain; the well of searching
Avim	wicked or perverse men
Aharhel	another host; the last sorrow; a brother's sheep
Immer	saying; speaking; a lamb
Bichri	first-born; first fruits
Zobah	an army; warring
Eben-ezer	the stone of help
Abram	high father
Uri	my light, my fire
Pergamos	height; elevation
Huppim	a chamber covered; the sea-shore
Cappadocia	the same as Caphtor
Geba	a hill; cup
Abilene	the father of mourning
Gaddi	my troop; a kid
Carshena	a lamb; sleeping
Ibhar	election; he that is chosen
Ishmaiah	hearing or obeying the Lord
Kirjath-arim	city of those who watch
Ophir	fruitful region
Asaiah	the Lord hath wrought
Jacob	that supplants, undermines; the heel
Baara	a flame; purging
Ramath-mizpeh	elevation of the watch-tower
Kabzeel	the congregation of God
Jethlah	hanging up; heaping up
Genubath	theft; robbery
Omar	he that speaks; bitter
Ziza	same as Zina
Hara	a hill; showing forth
Ibniah	the building of the Lord; the understanding of the Lord;
Jesui	even-tempered; flat country
Jesus	savior; deliverer
Siloa	same as Shilhi
Siloe	same as Shilhi
Lysias	dissolving
Sacar	wares; a price
Epenetus	laudable; worthy of praise
Caphtor	a sphere, buckle, or hand
Raamah	greatness; thunder; some sort of evil
Mithredath	breaking the law
Zachariah	memory of the Lord
Eglaim	drops of the sea
Shoshannim	those that shall be changed
Tabbath	good; goodness
Tamar	palm; palm-tree
Zephath	which beholds; that attends or that covers
Hobah	love; friendship; secrecy
Huz	counsel; woods; fastened
Hobab	favored; beloved
Magdala	tower; greatness
Chedorlaomer	roundness of a sheaf
Sethur	hid; destroying
Tamah	blotting or wiping out; smiting
Pentateuch	the five books of Moses
Hul	pain; infirmity
Parmashta	a yearling bull
Phygellus	fugitive
Asa	physician; cure
Hanan	full of grace
Athach	thy time
Shelemiah	God is my perfection; my happiness; my peace
Kartah	calling; meeting
Pithon	mouthful; persuasion
Pithom	their mouthful; a dilatation of the mouth
Rohgah	filled or drunk with talk
Baal-zephon	the idol or possession of the north; hidden; secret
Asia	muddy; boggy
Ashbel	an old fire
Hadoram	their beauty; their power
Gazzam	the fleece of them
Japhia	enlightening; appearing
Ozni	an ear; my hearkening
Janum	sleeping
Etham	their strength; their sign
Ethan	strong; the gift of the island
Milalai	circumcision; my talk
Chephirah	a little lioness
Abishai	the present of my father
Crispus	curled
Zelzah	noontide
Nazarite	one chosen or set apart
Shishak	present of the bag; of the pot; of the thigh
Beth-pazzez	house of dividing asunder
Prisca	ancient
Makheloth	assemblies; congregations
Nehelamite	dreamer; vale; brook
Japhleti	delivered; banished
Jarmuth	fearing, or seeing, or throwing down, death
Mahalath	sickness; a company of dancers; a harp
Ezekiel	the strength of God
Geder	a wall
Aiath	same as Ai; an hour; eye; fountain
Ornan	that rejoices
Nicodemus	victory of the people
Abana	made of stone; a building
Benhadad	son of Hadad, or noise
Kenah	buying; possession
Kenan	buyer; owner
Ezion-geber	the wood of the man
Assos	approaching; coming near
Baal-meon	idol or master of the house
Succoth	tents; tabernacles
Sela	a rock
Machnadebai	smiter
Tehinnah	entreaty; a favor
Antipatris	for, or against the father
Nethaniah	the gift of the Lord
Calcol	nourishing
Hakkatan	little
Asriel	help of God
Abijah	the Lord is my father
Kenaz	this purchase; this lamentation
Abijam	father of the sea
Lebaoth	lividness
Jothatha	his goodness
Haradah	well of great fear
Abihud	father of praise; confession
Benjamin	son of the right hand
Eunice	good victory
Bithynia	violent precipitation
Jeriah	fear, or throwing down, of the Lord
Mizar	little
Shenir	lantern; light that sleeps
Habazinaiah	a hiding of the shield of the Lord
Dishan	a threshing
Toah	weapon; dart
Raphah	relaxation; physic; comfort
Apollonius	destroying
Methusael	who demands his death
Hadassah	a myrtle; joy
Rephidim	beds; places of rest
Shephatiah	the Lord that judges
Zaham	crime; filthiness; impurity
Hazar-susah	or susim, the hay-paunch of a horse
Ziph	this mouth or mouthful; falsehood
Elisabeth	the oath, or fullness, of God
Evil-merodach	the fool of Merodach; the fool grinds bitterly
Mizpeh	a watch-tower; speculation
Hadad	joy; noise; clamor
Sabeans	captivity; conversion; old age
Manoah	rest; a present
Ahisamach	brother of strength
Imnah	same as Jimnah
Hadar	power; greatness
Jathniel	gift of God
Gazer	a dividing; a sentence
Lubin	heart of a man; heart of the sea
Ruhamah	having obtained mercy
Timon	honorable; worthy
Tatnai	that gives; the overseer of the gifts and tributes
Ishbak	who is empty or exhausted
Malchijah	the Lord my king, or my counselor
Pahath-Moab	ruler of Moab
Helbah	milk, fatness
Eltekeh	of grace or mercy
Emmaus	people despised or obscure
Jubal	he that runs; a trumpet
Jeroboam	he that opposes the people
Ivah	iniquity
Riphath	remedy; medicine; release; pardon
Harran	see Charran
Bigvai	in my body
Beth-gamul	house of recompense, or of the camel
Pekahiah	it is the Lord that opens
Cana	zeal; jealousy; possession
Marsena	bitterness of a bramble
Hezer	a bog; converted
Abi-albon	most intelligent father
Darah	generation; house of the shepherd or of the companion
Hezrai	an entry or vestibule
Ner	a lamp; new-tilled land
Tishbite	that makes captive
Hazar-shual	a wolf's house
Zer	perplexity
Haniel	the gift of God
Parmenas	that abides, or is permanent
Nergal-sharezer	treasurer of Nergal
Meah	a hundred cubits
Haggi	a stranger
Malachi	my messenger; my angel
Jeremiah	exaltation of the Lord
Cosam	divining
Dinhabah	he gives judgment
Moreh	stretching
Simeon	that hears or obeys; that is heard
Jehu	himself who exists
Heshbon	invention; industry
Jehoahaz	possession of the Lord
Bigthan	in the press; giving meat
Shimeon	same as Simeon
Misrephoth-maim	hot waters
Ataroth-addar	crowns of power
Ben	a son
Sinim	south country,
Ahava	essence; being; generation
Saphir	delightful
Giddel	great
Shalmaneser	peace; tied; chained; perfection; retribution
Harim	destroyed; dedicated to God
Ashdod	effusion; inclination; theft
Ishma	named; marveling; desolation
Bithiah	daughter of the Lord
Shemer	guardian; thorn
Gamaliel	recompense of God; camel of God
Coos	top, summit
Raamiah	thunder, or evil, from the Lord
Artemas	whole, sound
Shuham	talking; thinking; humiliation; budding
Ziddim	huntings; treasons; destructions
Jachan	wearing out; oppressing
Bezek	lightning; in the chains
Bezer	vine branches
Jaazaniah	whom the Lord will hear
Azaziah	strength of the Lord
Dabbasheth	flowing with honey
Harbonah	his destruction; his sword
Shebaniah	the Lord that converts, or recalls from captivity
Shamer	prison; bush; lees; thorn
Rakkath	empty; temple of the head
Nephish	same as Naphish
Zarephath	ambush of the mouth
Elkanah	God the zealous; the zeal of God
Jebus	treading under foot; manger
Benaiah	son of the Lord
Sardites	removing a dissension
Delaiah	the poor of the Lord
Makkedah	worshiping; burning; raised; crookedness
Abihail	the father of strength
Gabbai	the back
Shethar-boznai	that makes to rot; that seeks those who despise me
Ludim	same as Lod
Jether	he that excels
Ehud	he that praises
Boanerges	son of thunder
Pai	howling; sighing
Bether	division, or in the trial
Ahoah	a live brother; my thorn or thistle
Jattir	a remnant; excellent
Naashon	that foretells; that conjectures
Ahimoth	brother of death
Heleph	changing; passing over
Pau	same as Pai
Magog	covering; roof; dissolving
Fortunatus	lucky, fortunate
Crescens	growing; increasing
Ajalon	a chain; strength; a stag
Kadmiel	God of antiquity; God of rising
Sarah	lady; princess; princess of the multitude
Joatham	same as Jotham
Hushim	man of haste, or of silence
Toi	who wanders
Hathath	fear
Hanniel	grace or mercy of God
Maranatha	the Lord is coming
Syene	a bush; enmity
Tob	good; goodness
Thyatira	a perfume; sacrifice of labor
Luke	luminous; white
Gederoth	a wall
Chebar	force or strength
Dalaiah	the poor of the Lord
Shemida	name of knowledge; that puts knowledge
Hashabnah	the silence of the Lord
Jaresiah	the bed of the Lord; the Lord hath taken away; poverty
Salah	mission; sending
Merodach	bitter contrition
Arcturus	a gathering together
Gideon	he that bruises or breaks; a destroyer
Jobab	sorrowful, hated
Chuza	the seer or prophet
Ashnah	change
Asaph	who gathers together
Paphos	which boils, or is very hot
Jeremoth	eminences; one that fears death
Eliah	God the Lord
Nibhaz	budding; prophesying
Ahiah	brother of the Lord
Gideoni	same as Gideon
Ahiam	mother's brother; brother of a nation
Ahian	brother of wine
Salome	same as Salmon
Telharsa	suspension of the plow
Misheal	requiring; lent; pit
Jericho	his moon; his month; his sweet smell
El-elohe-Israel	God, the God of Israel
Anamim	a fountain; answer; affliction
Methusaleh	he has sent his death
Ahinoam	beauty of the brother; brother of motion
Mahaleleel	praising God
Non	posterity; a fish; eternal
Genesis	beginning
Michmethah	the gift or death of a striker
Achan	or Achar, he that troubleth
Adami	my man; red; earthy; human
Achab	brother of the father
Shuni	changed; sleeping
Achaz	one that takes, or possesses
Elias	same as Elijah
Mezahab	gilded
Ohel	tent; tabernacle; brightness
Beth-gader	a house for a mouse
Semei	hearing; obeying
Azariah	he that hears the Lord
Gerizim	cutters, hatchets
Ahi	my brother; my brethren
Rehpaim	giants; physicians; relaxed
Zalmonah	the shade; the sound of the number; his image
Corinth	which is satisfied; ornament; beauty
Shabbethai	my rest
Beth-rapha	house of health
Galatia	white; the color of milk
Ira	watchman; making bare; pouring out
Hachilah	my hope is in her
Jehovah-tsidkenu	the Lord our righteousness
Beth-baalmeon	an idol of the dwelling-place
Amok	a valley; a depth
Tob-adonijah	my good God; the goodness of the foundation of the Lord
Merodach-baladan	bitter contrition, without judgment
Jose	raised; who pardons
Abel-maim	mourning of waters
Obed-edom	servant of Edom
Amoz	strong; robust
Harhaiah	heat, or anger, of the Lord
Baalath-beer	subjected pit
Demas	popular
Troas	penetrated
Talitha-cumi	young woman, arise
Asyncritus	incomparable
Joab	paternity; voluntary
Ahitub	brother of goodness
Baal	master; lord
Ozias	strength from the Lord
Secacah	shadow; covering; defense
Jecamiah	resurrection, or confirmation, or revenge, of the Lord
Rei	my shepherd; my companion; my friend
Shobek	made void; forsaken
Almodad	measure of God
Beeroth	wells; explaining
Ahihud	brother of vanity, or of darkness, or of joy, or of praise;
Jehozadak	justice of the Lord
Bochim	the place of weeping; or of mulberry-trees
Bathsuha	same as Bathsheba
Ahijah	same with Ahiah
Amal	labor; iniquity
Aman	mother; fear of them
Ethiopia	blackness; heat
Berodach-baladan	the son of death
Amad	people of witness; a prey
Beersheba	the well of an oath; the seventh well
En-eglaim	eye, or fountain, of calves
Melchiah	God is my king
Harhas	anger; heat of confidence
Eliathah	thou art my God
Zaccur	of the male kind; mindful
Tema	admiration; perfection; consummation
Harumaph	destruction
Hebron	society; friendship
Apharsites	(from a root meaning) dividing or rending
Michael	same as Micah
Shelesh	captain; prince
Meremoth	bitterness; myrrh of death
Elead	witness of God
Jaaziah	the strength of the Lord
Jason	he that cures
Abiel	God my father
Gemariah	accomplishment or perfection of the Lord
Rehoboth	spaces; places
Antioch	speedy as a chariot
Goshen	approaching; drawing near
Derbe	a sting
Shimon	providing well; fatness; oil
Tertullus	third
Meonenim	charmers, regarders of times
Phenice	Phoenicia, red; purple
Magdalene	a person from Magdala
Lud	same as Lod
Eliphalet	the God of deliverance
Keren-happuch	the horn or child of beauty
Jesher	right; singing
Jibsam	their drought, their confusion
Shua	crying; saving
Heli	ascending; climbing up
Hirah	liberty; anger
Mizraim	tribulations
Narcissus	astonishment; stupidity
Shear-jashub	the remnant shall return
Shur	wall; ox; that beholds
Neapolis	the new city
Kedemoth	antiquity; old age
Jaanai	answering; afflicting; making poor
Tartak	chained; bound; shut up
Tartan	a general (official title)
Hagar	a stranger; one that fears
Tiria	searching out
Marcus	polite; shining
Asuppim	gatherings
Carcas	the covering of a lamb
Jedidah	well beloved; amiable
Shimshai	my son
Hagab	a grasshopper
Hazor	court; hay
Barnabas	son of the prophet, or of consolation
Perga	very earthy
Esli	near me; he who separates
Sosthenes	savior; strong; powerful
Jerusha	banished; possession; inheritance
Clement	mild; good; merciful
Sharon	his plain; his song
Caleb	a dog; a crow; a basket
Irad	wild ass; heap of empire; dragon
Paul	small; little
Aharah	a smiling brother; a meadow of a sweet savor
Mahlon	same as Mahali
Jekuthiel	hope, or congregation, of the Lord
Sichem	portion; shoulder
Ishod	a comely man
Sharar	navel; thought; singing
Gebim	grasshoppers; height
Uzzi	my strength; my kid
Mijamin	right hand
Buz	despised; plundered
Raphu	relaxation; physic; comfort
Sharai	my lord; my prince; my song
Azor	a helper; a court
Herod	son of a hero
Noha	rest; a guide
Jonadab	who gives liberally
Berea	heavy; weighty
Heman	their trouble; tumult; much; in great number
Bered	hail
Agar	or Hagar, a stranger; one that fears
Seled	affliction; warning
Jeziah	sprinkling of the Lord
Halhul	grief; looking for grief
Epicurean	follower of Epicurus, i.e., of one who gives assistance
Miniamin	right hand
Perida	separation; division
Gozan	fleece; pasture; who nourisheth the body
Shiggaion	a song of trouble or comfort
Shenazar	treasurer of a tooth
Ithai	strong; my sign; a plowshare
Jehovah-shalom	the Lord send peace
Pontus	the sea
Dannah	judging
Naboth	words; prophecies
Alpheus	a thousand; learned; chief
Aristarchus	the best prince
Jerusalem	vision of peace
Saron	same as Sharon
Aijeleth-Shahar	the land of the morning
Jeuel	God hath taken away; God heaping up
Joiarib	chiding, or multiplying, of the Lord
Pamphylia	a nation made up of every tribe
Karkaa	floor; dissolving coldness
Izehar	clearness; oil
Galilee	wheel; revolution
Mozah	unleavened
Deuteronomy	repetition of the law
Lahmi	my bread; my war
Publius	common
Meshezaheel	God taking away; the salvation of God
Armageddon	hill of fruits; mountain of Megiddo
Tibbath	killing; a cook
Shimri	thorn; dregs
Hazezon-tamar	drawing near to bitterness
Zeredah	ambush; change of dominion
Beten	belly
Melchizedek	king of justice
Doeg	careful, who acts with uneasiness
Hupham	their chamber; their bank
Berachah	blessing; bending the knee
Azotus	the same as Ashdod
Nemuel	the sleeping of God
Shalmai	my garment
Dildah	his diminishing
Abagtha	father of the wine-press
Ethnan	gift
Hazeroth	villages; palaces
Phrygia	dry; barren
Amariah	the Lord says; the integrity of the Lord
Keturah	that makes the incense to fume
Binnui	building
Elohim	God
Haggiah	the Lord's feast
Shalman	peaceable; perfect; that rewards
Italy	abounding with calves or heifers
Baal-perazim	god of divisions
Silla	exalting
Esrom	dart of joy; division of a song
Kezia	superficies; the angle; cassia
Seraphim	burning; fiery
Arpad	the light of redemption
Mattenai	gifts; rains
Hashem	named; a putting to
Pelaiah	the Lord's secret or miracle
Keziz	end; extremity
Dibon	abundance of knowledge
Beth-dagon	the house of corn, or of fish
Tahath	fear; going down
Eshkalon	same as Askelon
Kohath	congregation; wrinkle; bluntness
Jehucal	mighty; perfect; wasted
Almon	hidden
Moab	of his father
Gilgal	wheel; rolling; heap
Bocheru	the first born
Shiza	this gift
Abiathar	excellent father; father of the remnant
Zebul	a habitation
Drusilla	watered by the dew
Dorcas	a female roe-deer
Hammedatha	he that troubles the law
Martha	who becomes bitter; provoking
Jehovah	self-subsisting
Beth-haccerem	house of the vineyard
Aenon	a cloud; fountain; his eye
Jokneam	possessing, or building up, of the people
Geber	manly, strong
Machpelah	double
Arabia	evening; desert; ravens
Senir	bed-candle; changing
Medeba	waters of grief; waters springing up
Helbon	milk, fatness
Jakan	same as Achan
Jeshohaia	the Lord pressing; the meditation of God
Zelek	the shadow or noise of him that licks or laps
Jabbok	evacuation; dissipation; wrestling
Zepho	that sees and observes; that expects or covers
Tarpelites	ravishers; succession of miracles
Nehemiah	consolation; repentance of the Lord
Jehosheba	fullness, or oath, of the Lord
Shamariah	throne or keeping of the Lord
Issachar	reward; recompense
Melchi	my king; my counsel
Ammon	a people; the son of my people
Sopater	who defends the father
Aminadab	same as Amminadab
Timeus	perfect; admirable; honorable
Appaim	face; nostrils
Hasadiah	the mercy of the Lord
Joash	who despairs or burns
Punon	precious stone; that beholds
Alian	high
Shobal	path; ear of corn
Shobai	turning captivity
Amzi	strong, mighty
Rephaiah	medicine or refreshment of the Lord
Shobab	returned; turned back; a spark
Zaphnath-paaneah	one who discovers hidden things
Abihu	he is my father
Shihon	sound; wall of strength
Lasea	thick; wise
Trachonitis	stony
Eliud	God is my praise
Peninnah	pearl; precious stone; the face
Manasseh	forgetfulness; he that is forgotten
Beor	burning; foolish; mad
Hashabiah	the estimation of the Lord
Junia	youth
Mibsam	smelling sweet
Naioth	beauties; habitations
Shimeath	that hears, or obeys; perdition
Seraiah	prince of the Lord
Adithaim	assemblies; testimonies
Nob	discourse; prophecy
Apharsathchites	(from a root meaning) dividing or rending
Onam	same as On
Jorim	he that exalts the Lord
Sepharvaim	the two books; the two scribes
Rehoboam	who sets the people at liberty
Sem	same as Shem
Reaiah	vision of the Lord
Philippi	same as Philip, in the plural
Telah	moistening; greenness
Thessalonica	victory against the Thessalians
Heber	one that passes; anger
Anathoth	or Anath, answer; song; poverty
Hadrach	point; joy of tenderness
Hethlon	a fearful dwelling
Hammelech	a king; a counselor
Lot	wrapt up; hidden; covered; myrrh; rosin
Magbish	excelling; height
Zeror	root; that straitens or binds; that keeps tight
Uriah	or Urijah, the Lord is my light or fire
Mahazioth	seeing a sign; seeing a letter
Halloesh	saying nothing; an enchanter
Kemuel	God hath raised up, or established him
Lod	nativity; generation
Shebuel	turning, or captivity, or seat, of God
Ananias	or Ananiah, the cloud of the Lord
Gihon	valley of grace
Elika	pelican of God
Iri	fire; light
Hena	troubling
Parah	a cow; increasing
Sud	my secret
Clauda	a lamentable voice
Lo-ammi	not my people
Elienai	the God of my eyes
Sur	that withdraws or departs; rebellion
Malchom	their king; their counselor
Shage	touching softly; multiplying much
Shallum	perfect; agreeable
Gur	the young of a beast; a whelp
Giloh	he that rejoices; he that overturns
Shimma	same as Shimeah
Sapphira	that relates or tells
Nimrah	leopard; bitterness; rebellion
Zion	monument; raised up; sepulcher
Jaziz	brightness; departing
Nebaioth	words; prophecies; buds
Perizzites	dwelling in villages
Lysanias	that drives away sorrow
Rehob	breadth; space; extent
Naamah	beautiful; agreeable
Nophah	fearful; binding
Ephron	dust
Naaman	beautiful; agreeable
Zior	ship of him that watches
Chalcol	who nourishes, consumes, and sustains the whole
Elteketh	the case of God
Silvanus	who loves the forest
Nahamani	comforter; leader
Mishmannah	fatness; taking away provision
Agag	roof; upper floor
Neginoth	stringed instruments
Achmetha	brother of death
Smyrna	myrrh
Jerahmeel	the mercy, or the beloved, of God
Mephibosheth	out of my mouth proceeds reproach
Phinehas	bold aspect; face of trust or protection
Cabul	displeasing; dirty
Sibbechai	bough; cottage; of springs
Masrekah	whistling; hissing
Jabesh	dryness; confusion; shame
Ethbaal	toward the idol, or with Baal
Ara	cursing; seeing
Gerar	same as Gera
Darkon	of generation; of possession
Arumah	high; exalted
Joppa	beauty; comeliness
Ashan	smoke
Joshbekesha	it is requiring or beseeching
Oded	to sustain, hold or lift up
Ezem	a bone
Tobiah	the Lord is good
Beth-diblathaim	house of dry figs
Maralah	sleep; a sacrifice of myrrh; ascension
Rome	strength; power
Ezer	a help
Shiphrah	handsome; trumpet; that does good
Harhur	made warm
Uzziah	the strength, or kid, of the Lord
Lydia	a standing pool
Besai	a despising; dirty
Hezron	the dart of joy; the division of the song
Nibshan	prophecy; growing of a tooth
Media	measure; habit; covering
Gehazi	valley of sight
Sheba	captivity; old man; repose; oath
Beth-horon	house of wrath
Niger	black
Mishraites	spread abroad
Minneiah	possession of the Lord
Samson	his sun; his service; there the second time
Adina	adorned; voluptuous; dainty
Zareah	leprosy; hornet
Seorim	gates; hairs; tempests
Shemariah	God is my guard
Migdol	a tower
Sallu	an exaltation; a basket
Zidkijah	justice of the Lord
Shammoth	names; desolations
Chesed	as a devil, or a destroyer
Argob	a turf, or fat land
Shalim	same as Salim
Judith	same as Judah
Schaaph	fleeing; thinking
Jared	a ruling; commanding; coming down
Jareb	a revenger
Tabeel	good God
Jehdeiah	joy together, one Lord
Jehonathan	gift of the Lord; gift of a dove
Naam	fair; pleasant
Betonim	bellies
Zarah	east; brightness
Hiram	exaltation of life; a destroyer
Abitub	father of goodness
Becher	first begotten; first fruits
Hephzibah	my delight is in her
Abimael	a father sent from God
Sergius	net
Barabbas	son of shame, confusion
Pison	changing; extension of the mouth
Hodesh	a table; news
Molech	king
Urim	lights; fires
Priscilla	same as Prisca
Jabin	he that understands; building
Golgotha	a heap of skulls; something skull-shaped
En-hakkore	fountain of him that called or prayed
Mahalah	sickness; a company of dancers; a harp
Nicolaitanes	followers of Nicolas
Jeshua	same as Joshua
Casleu	rashness; confidence
Rissah	watering; distillation; dew
Buzi	my contempt
Gur-baal	the governor's whelp
Coniah	strength of the Lord
Zedekiah	the Lord is my justice; the justice of the Lord
Jahaziel	seeing God
Raca	worthless; good-for-nothing
Jehovah-shammah	the Lord is there
Pekah	he that opens; that is at liberty
Josabad	having a dowry
Boskath	in poverty
Lehi	jawbone
Meraioth	bitterness; rebellious; changing
Remmon	greatness; elevation; a pomegranate-tree
Jude	same as Judah
Eri	my city
Zur	stone; rock; that besieges
Migron	fear; farm; throat
Behemoth	beasts
Maai	belly; heaping up
Esh-baal	the fire of the idol, or of the ruler
Beon	in affliction
Bishlam	in peace
Dekar	force
Sargon	who takes away protection
Javan	deceiver; one who makes sad
Shen	tooth; ivory; change
Nun	same as Non
Shem	name; renown
Gath	a wine-press
Baal-gad	idol of fortune or felicity
Giah	to guide; draw out; produce; a groan or sigh
Hodijah	same as Hodaiah
Ithamar	island of the palm-tree
Jeziel	sprinkling of the Lord
Ahilud	a brother born, or begotten
Shubael	returning captivity; seat of God
Hamor	an ass; clay; dirt
Sabtechah	that surrounds; that causes wounding
Vaniah	nourishment, or weapons, of the Lord
Nicolas	same as Nicodemus
Ginnetho	a garden
Shilhim	bough; weapon; armor
Ish-pan	hid; broken in two
Saruch	branch; layer; lining
Theudas	flowing with water
Josaphat	same as Jehoshaphat
Adoni-bezek	the lightning of the Lord; the Lord of lightning
Beriah	in fellowship; in envy
Zeresh	misery; strange; dispersed inheritance
Aholiab	the tent of the father
Cushan	Ethiopians; blackness
